adejong          =   adejong <adejong@tigris.org>
aogier           =   aogier <aogier@tigris.org>
archiecobbs      =   archiecobbs <archiecobbs@tigris.org>
ballbach         =   ballbach <ballbach@tigris.org>
bcollins         =   bcollins <bcollins@tigris.org>
bdenny           =   bdenny <bdenny@tigris.org>
bhuvan           =   bhuvan <bhuvan@tigris.org>
blair            =   blair <blair@tigris.org>
blueboh          =   blueboh <blueboh@tigris.org>
brane            =   brane <brane@tigris.org>
breser           =   breser <breser@tigris.org>
cacknin          =   cacknin <cacknin@tigris.org>
cauchy           =   cauchy <cauchy@tigris.org>
clkao            =   clkao <clkao@tigris.org>
cmpilato         =   cmpilato <cmpilato@tigris.org>
danderson        =   danderson <danderson@tigris.org>
daniel           =   daniel <daniel@tigris.org>
danpat           =   danpat <danpat@tigris.org>
dberlin          =   dberlin <dberlin@tigris.org>
dbrouard         =   dbrouard <dbrouard@tigris.org>
dimentiy         =   dimentiy <dimentiy@tigris.org>
dionisos         =   dionisos <dionisos@tigris.org>
djames           =   djames <djames@tigris.org>
djh              =   djh <djh@tigris.org>
dkagedal         =   dkagedal <dkagedal@tigris.org>
dlr              =   dlr <dlr@tigris.org>
dustin           =   dustin <dustin@tigris.org>
dwhedon          =   dwhedon <dwhedon@tigris.org>
dws              =   dws <dws@tigris.org>
ebswift          =   ebswift <ebswift@tigris.org>
epg              =   epg <epg@tigris.org>
fabien           =   fabien <fabien@tigris.org>
fitz             =   fitz <fitz@tigris.org>
fmatias          =   fmatias <fmatias@tigris.org>
gerhardoettl     =   gerhardoettl <gerhardoettl@tigris.org>
ghudson          =   ghudson <ghudson@tigris.org>
giorgio_valoti   =   giorgio_valoti <giorgio_valoti@tigris.org>
giovannibajo     =   giovannibajo <giovannibajo@tigris.org>
glasser          =   glasser <glasser@tigris.org>
gradha           =   gradha <gradha@tigris.org>
gstein           =   gstein <gstein@tigris.org>
gthompson        =   gthompson <gthompson@tigris.org>
hwright          =   hwright <hwright@tigris.org>
hynnet           =   hynnet <hynnet@tigris.org>
jaa              =   jaa <jaa@tigris.org>
jerenkrantz      =   jerenkrantz <jerenkrantz@tigris.org>
jespersm         =   jespersm <jespersm@tigris.org>
jimb             =   jimb <jimb@tigris.org>
jlvarner         =   jlvarner <jlvarner@tigris.org>
joe              =   joe <joe@tigris.org>
joeswatosh       =   joeswatosh <joeswatosh@tigris.org>
josander         =   josander <josander@tigris.org>
jpeacock         =   jpeacock <jpeacock@tigris.org>
jpieper          =   jpieper <jpieper@tigris.org>
jrepenning       =   jrepenning <jrepenning@tigris.org>
jrvernooij       =   jrvernooij <jrvernooij@tigris.org>
jszakmeister     =   jszakmeister <jszakmeister@tigris.org>
julianfoad       =   julianfoad <julianfoad@tigris.org>
jzgoda           =   jzgoda <jzgoda@tigris.org>
kameshj          =   kameshj <kameshj@tigris.org>
karolszk         =   karolszk <karolszk@tigris.org>
kellin           =   kellin <kellin@tigris.org>
kevin            =   kevin <kevin@tigris.org>
kfogel           =   kfogel <kfogel@tigris.org>
khmarbaise       =   khmarbaise <khmarbaise@tigris.org>
knacke           =   knacke <knacke@tigris.org>
kon              =   kon <kon@tigris.org>
kou              =   kou <kou@tigris.org>
kraai            =   kraai <kraai@tigris.org>
lgo              =   lgo <lgo@tigris.org>
luebbe           =   luebbe <luebbe@tigris.org>
lundblad         =   lundblad <lundblad@tigris.org>
madanus          =   madanus <madanus@tigris.org>
malcolm          =   malcolm <malcolm@tigris.org>
marcelg          =   marcelg <marcelg@tigris.org>
marcosc          =   marcosc <marcosc@tigris.org>
markphip         =   markphip <markphip@tigris.org>
martinto         =   martinto <martinto@tigris.org>
maxb             =   maxb <maxb@tigris.org>
mbk              =   mbk <mbk@tigris.org>
mf               =   mf <mf@tigris.org>
mhagger          =   mhagger <mhagger@tigris.org>
mmacek           =   mmacek <mmacek@tigris.org>
morten           =   morten <morten@tigris.org>
mprice           =   mprice <mprice@tigris.org>
mthelen          =   mthelen <mthelen@tigris.org>
naked            =   naked <naked@tigris.org>
niemeyer         =   niemeyer <niemeyer@tigris.org>
nikclayton       =   nikclayton <nikclayton@tigris.org>
niqueco          =   niqueco <niqueco@tigris.org>
nomis80          =   nomis80 <nomis80@tigris.org>
nori             =   nori <nori@tigris.org>
nsd              =   nsd <nsd@tigris.org>
offby1           =   offby1 <offby1@tigris.org>
oyvindmo         =   oyvindmo <oyvindmo@tigris.org>
pburba           =   pburba <pburba@tigris.org>
philip           =   philip <philip@tigris.org>
plasma           =   plasma <plasma@tigris.org>
pll              =   pll <pll@tigris.org>
pmarek           =   pmarek <pmarek@tigris.org>
pmayweg          =   pmayweg <pmayweg@tigris.org>
pynoos           =   pynoos <pynoos@tigris.org>
rassilon         =   rassilon <rassilon@tigris.org>
rey4             =   rey4 <rey4@tigris.org>
ringstrom        =   ringstrom <ringstrom@tigris.org>
rocksun          =   rocksun <rocksun@tigris.org>
rooneg           =   rooneg <rooneg@tigris.org>
ruben            =   ruben <ruben@tigris.org>
sage             =   sage <sage@tigris.org>
sergeyli         =   sergeyli <sergeyli@tigris.org>
shlomif          =   shlomif <shlomif@tigris.org>
sigfred          =   sigfred <sigfred@tigris.org>
striker          =   striker <striker@tigris.org>
sunny256         =   sunny256 <sunny256@tigris.org>
sussman          =   sussman <sussman@tigris.org>
svn              =   svn <svn@tigris.org>
trow             =   trow <trow@tigris.org>
vgeorgescu       =   vgeorgescu <vgeorgescu@tigris.org>
wein             =   wein <wein@tigris.org>
wsanchez         =   wsanchez <wsanchez@tigris.org>
xela             =   xela <xela@tigris.org>
xsteve           =   xsteve <xsteve@tigris.org>
yoshiki          =   yoshiki <yoshiki@tigris.org>
zbrown           =   zbrown <zbrown@tigris.org>
zhakov           =   zhakov <zhakov@tigris.org>
