adezm           =   adezm@tigris.org
appel           =   appel@tigris.org
bertil          =   bertil@tigris.org
bociusz         =   bociusz@tigris.org
bodyguard       =   bodyguard@tigris.org
cauchy          =   Dongsheng Song <dongsheng.song@gmail.com>
daibo           =   daibo@tigris.org
dimentiy        =   dimentiy@tigris.org
eckardt         =   eckardt@tigris.org
fernandonajera  =   fernandonajera@tigris.org
Giasher         =   Giasher@tigris.org
humberto0       =   humberto0@tigris.org
jbadier         =   jbadier@tigris.org
jcgigogne       =   jcgigogne@tigris.org
jeanmarc        =   jeanmarc@tigris.org
josander        =   josander@tigris.org
kgr             =   kgr@tigris.org
luebbe          =   luebbe@tigris.org
moskovich       =   moskovich@tigris.org
mradev          =   mradev@tigris.org
msaric          =   msaric@tigris.org
nabetaro        =   nabetaro@tigris.org
netcobra        =   netcobra@tigris.org
NetCobra        =   NetCobra@tigris.org
normann         =   normann@tigris.org
otik            =   otik@tigris.org
petemounce      =   petemounce@tigris.org
project2501a    =   project2501a@tigris.org
pynoos          =   pynoos@tigris.org
rdk             =   rdk@tigris.org
rocksun         =   rocksun@tigris.org
root            =   root@tigris.org
rusin           =   rusin@tigris.org
schaefer        =   schaefer@tigris.org
SF              =   SF@tigris.org
simonlarge      =   simonlarge@tigris.org
stannic         =   stannic@tigris.org
Stannic         =   Stannic@tigris.org
steveking       =   steveking@tigris.org
tepting         =   tepting@tigris.org
tew             =   tew@tigris.org
try876          =   try876@tigris.org
wdean           =   wdean@tigris.org
wxy             =   wxy@tigris.org
zcecil          =   zcecil@tigris.org
